R 1920 1080

NO ./pics/colorstone.png
SO ./pics/bluestone.png
WE ./pics/greystone.png
EA ./pics/redbrick.png

S ./pics/barrel.png

FT ./pics/mossy.png
CT ./pics/wood.png

111111111111111111111111111111111111111111111111111111111111111111111111111111111111111111111111111111111111111111111111111111111111111111111111111111111111111111111111111111111111111111111111111111111111111111111111111111111111111111111111111111111111111111111
100000000011000000000000000011000000000110000000000000000110000000001100000000000000001100000000011000000000000000011000000000110000000000000000110000000001100000000000000001100000000011000000000000000011000000000110000000000000000110000000001100000000000000001
101100000111000000200000100011011000001110000002000001000110110000011100000020000010001101100000111000000200000100011011000001110000002000001000110110000011100000020000010001101100000111000000200000100011011000001110000002000001000110110000011100000020000010001
100100000000000000000000100011001000000000000000000001000110010000000000000000000010001100100000000000000000000100011001000000000000000000001000110010000000000000000000010001100100000000000000000000100011001000000000000000000001000110010000000000000000000010001
101100000111000000000000100011011000001110000000000001000110110000011100000000000010001101100000111000000000000100011011000001110000000000001000110110000011100000000000010001101100000111000000000000100011011000001110000000000001000110110000011100000000000010001
100000000011000001110111100011000000000110000011101111000110000000001100000111011110001100000000011000001110111100011000000000110000011101111000110000000001100000111011110001100000000011000001110111100011000000000110000011101111000110000000001100000111011110001
111101111111110111000000100011111011111111101110000001000111110111111111011100000010001111101111111110111000000100011111011111111101110000001000111110111111111011100000010001111101111111110111000000100011111011111111101110000001000111110111111111011100000010001
111101111111110111010100100011111011111111101110101001000111110111111111011101010010001111101111111110111010100100011111011111111101110101001000111110111111111011101010010001111101111111110111010100100011111011111111101110101001000111110111111111011101010010001
110000001101010111000000100011100000011010101110000001000111000000110101011100000010001110000001101010111000000100011100000011010101110000001000111000000110101011100000010001110000001101010111000000100011100000011010101110000001000111000000110101011100000010001
100020000000000011000000100011000200000000000110000001000110002000000000001100000010001100020000000000011000000100011000200000000000110000001000110002000000000001100000010001100020000000000011000000100011000200000000000110000001000110002000000000001100000010001
100000000000000011010100100011000000000000000110101001000110000000000000001101010010001100000000000000011010100100011000000000000000110101001000110000000000000001101010010001100000000000000011010100100011000000000000000110101001000110000000000000001101010010001
11000000110101011111011110N011100000011010101111101111000111000000110101011111011110001110000001101010111110111100011100000011010101111101111000111000000110101011111011110001110000001101010111110111100011100000011010101111101111000111000000110101011111011110001
111101111111010111110111100011111011111110101111101111000111110111111101011111011110001111101111111010111110111100011111011111110101111101111000111110111111101011111011110001111101111111010111110111100011111011111110101111101111000111110111111101011111011110001
111111111111111111111111111111111111111111111111111111111111111111111111111111111111111111111111111111111111111111111111111111111111111111111111111111111111111111111111111111111111111111111111111111111111111111111111111111111111111111111111111111111111111111111
